wwwwwwwwwwwwwwwwwwww
www...w.........w..w
w....w...w.w.wwwww.w
w.........www..w.w.w
w..w...w.w......w..w
w..w...w.ewww..ww.ww
w.w..w....www......w
ww...w.w.ww..ww.w..w
www.........w.w.w.ww
wwww..w....w.....w.w
w....w.w.w.w...w...w
w..ww.wwwwww.w.ww.ww
w......w....w.w.w.ww
ww.w....w..www.....w
www.x....w.........w
www.w............www
wwww.w.w.w...w....ww
w..w.w.....w.......w
ww..w..w...w.w.w.w.w
wwwwwwwwwwwwwwwwwwww
