wwwwwwwwww
ww.w.....w
w....w...w
w.ww.x.w.w
w.we.www.w
w.w....www
w...w.w..w
w.w...ww.w
w......www
wwwwwwwwww
